brokers:
  ftmo:
    mt4:
      XAUUSD: XAUUSD
      XAGUSD: XAGUSD
      EURUSD: EURUSD
      GBPUSD: GBPUSD
      USDJPY: USDJPY
      USDCAD: USDCAD
      EURJPY: EURJPY
      GBPCAD: GBPCAD
      GBPNZD: GBPNZD
      DJ30: US30.cash
      NAS100: US100.cash
      BTCUSD: BTCUSD
    mt5:
      XAUUSD: XAUUSD
      XAGUSD: XAGUSD
      EURUSD: EURUSD
      GBPUSD: GBPUSD
      USDJPY: USDJPY
      USDCAD: USDCAD
      EURJPY: EURJPY
      GBPCAD: GBPCAD
      GBPNZD: GBPNZD
      DJ30: US30.cash
      NAS100: US100.cash
      BTCUSD: BTCUSD

  traderscale:
    mt4:
      XAUUSD: XAUUSD
      XAGUSD: XAGUSD
      EURUSD: EURUSD
      GBPUSD: GBPUSD
      USDJPY: USDJPY
      USDCAD: USDCAD
      EURJPY: EURJPY
      GBPCAD: GBPCAD
      GBPNZD: GBPNZD
      DJ30: DJ30
      NAS100: NAS100
      BTCUSD: BTCUSD
    mt5:
      XAUUSD: XAUUSD
      XAGUSD: XAGUSD
      EURUSD: EURUSD
      GBPUSD: GBPUSD
      USDJPY: USDJPY
      USDCAD: USDCAD
      EURJPY: EURJPY
      GBPCAD: GBPCAD
      GBPNZD: GBPNZD
      DJ30: DJ30
      NAS100: NAS100
      BTCUSD: BTCUSD

  fundednext:
    mt4:
      XAUUSD: XAUUSD
      XAGUSD: XAGUSD
      EURUSD: EURUSD
      GBPUSD: GBPUSD
      USDJPY: USDJPY
      USDCAD: USDCAD
      EURJPY: EURJPY
      GBPCAD: GBPCAD
      GBPNZD: GBPNZD
      DJ30: US30
      NAS100: US100
      BTCUSD: BTCUSD
    mt5:
      XAUUSD: XAUUSD
      XAGUSD: XAGUSD
      EURUSD: EURUSD
      GBPUSD: GBPUSD
      USDJPY: USDJPY
      USDCAD: USDCAD
      EURJPY: EURJPY
      GBPCAD: GBPCAD
      GBPNZD: GBPNZD
      DJ30: US30
      NAS100: US100
      BTCUSD: BTCUSD

  vantage:
    mt4:
      XAUUSD: GOLD
      XAGUSD: SILVER
      EURUSD: EURUSD
      GBPUSD: GBPUSD
      USDJPY: USDJPY
      USDCAD: USDCAD
      EURJPY: EURJPY
      GBPCAD: GBPCAD
      GBPNZD: GBPNZD
      DJ30: US30
      NAS100: NAS100
      BTCUSD: BTCUSD
    mt5:
      XAUUSD: GOLD
      XAGUSD: SILVER
      EURUSD: EURUSD
      GBPUSD: GBPUSD
      USDJPY: USDJPY
      USDCAD: USDCAD
      EURJPY: EURJPY
      GBPCAD: GBPCAD
      GBPNZD: GBPNZD
      DJ30: US30
      NAS100: NAS100
      BTCUSD: BTCUSD

  startrader:
    mt4:
      XAUUSD: XAUUSD
      XAGUSD: XAGUSD
      EURUSD: EURUSD
      GBPUSD: GBPUSD
      USDJPY: USDJPY
      USDCAD: USDCAD
      EURJPY: EURJPY
      GBPCAD: GBPCAD
      GBPNZD: GBPNZD
      DJ30: US30
      NAS100: NAS100
      BTCUSD: BTCUSD
    mt5:
      XAUUSD: XAUUSD
      XAGUSD: XAGUSD
      EURUSD: EURUSD
      GBPUSD: GBPUSD
      USDJPY: USDJPY
      USDCAD: USDCAD
      EURJPY: EURJPY
      GBPCAD: GBPCAD
      GBPNZD: GBPNZD
      DJ30: US30
      NAS100: NAS100
      BTCUSD: BTCUSD

  vtmarkets:
    mt4:
      XAUUSD: XAUUSD
      XAGUSD: XAGUSD
      EURUSD: EURUSD
      GBPUSD: GBPUSD
      USDJPY: USDJPY
      USDCAD: USDCAD
      EURJPY: EURJPY
      GBPCAD: GBPCAD
      GBPNZD: GBPNZD
      DJ30: US30
      NAS100: NAS100
      BTCUSD: BTCUSD
    mt5:
      XAUUSD: XAUUSD
      XAGUSD: XAGUSD
      EURUSD: EURUSD
      GBPUSD: GBPUSD
      USDJPY: USDJPY
      USDCAD: USDCAD
      EURJPY: EURJPY
      GBPCAD: GBPCAD
      GBPNZD: GBPNZD
      DJ30: US30
      NAS100: NAS100
      BTCUSD: BTCUSD

  bullwaves:
    mt4:
      XAUUSD: XAUUSD
      XAGUSD: XAGUSD
      EURUSD: EURUSD
      GBPUSD: GBPUSD
      USDJPY: USDJPY
      USDCAD: USDCAD
      EURJPY: EURJPY
      GBPCAD: GBPCAD
      GBPNZD: GBPNZD
      DJ30: US30
      NAS100: NAS100
      BTCUSD: BTCUSD
    mt5:
      XAUUSD: XAUUSD
      XAGUSD: XAGUSD
      EURUSD: EURUSD
      GBPUSD: GBPUSD
      USDJPY: USDJPY
      USDCAD: USDCAD
      EURJPY: EURJPY
      GBPCAD: GBPCAD
      GBPNZD: GBPNZD
      DJ30: US30
      NAS100: NAS100
      BTCUSD: BTCUSD
